22 22
0 0
2 2 2 2 2 2 2 2 2 2 2 2 2 2 2 2 2 2 2 2 2 2
2 1 4 0 4 0 4 0 4 6 4 0 4 0 4 0 4 0 0 0 1 2
2 1 4 0 4 0 4 0 4 6 4 0 4 0 4 0 4 0 0 0 1 2
2 1 4 0 4 0 4 0 4 6 4 0 4 0 4 0 4 0 0 0 1 2
2 1 4 0 4 0 4 0 4 7 4 0 4 0 4 0 4 0 0 0 1 2
2 1 4 0 4 0 4 0 4 7 4 0 4 0 4 0 7 0 0 0 1 2
2 1 4 0 4 0 4 0 4 0 4 0 4 0 4 0 7 0 0 0 1 2
2 1 4 0 4 0 4 0 4 0 4 0 4 0 4 0 4 0 0 0 1 2
2 1 4 0 4 0 4 0 4 0 4 0 4 0 4 0 4 0 0 0 1 2
2 1 4 0 4 0 4 0 4 0 4 0 4 0 4 0 4 0 0 0 1 2
2 1 4 0 4 0 4 0 4 0 4 0 4 0 4 0 4 0 0 0 1 2
2 1 4 0 4 0 4 0 4 0 4 0 4 0 4 0 4 0 0 0 1 2
2 1 4 0 4 0 4 0 4 0 4 0 4 0 4 0 4 0 0 0 1 2
2 1 4 0 4 0 4 0 4 0 4 0 4 0 4 0 4 0 0 0 1 2
2 1 4 0 4 0 4 0 4 0 4 0 4 0 4 0 4 0 0 0 1 2
2 1 4 0 4 0 4 0 4 0 4 0 4 0 4 0 4 0 0 0 1 2
2 1 4 0 4 0 4 0 4 0 4 0 4 0 4 0 4 0 0 0 1 2
2 1 4 0 4 0 4 0 4 0 4 0 4 0 4 0 4 0 0 0 1 2
2 1 4 0 4 0 4 0 4 0 4 0 4 0 4 0 4 0 0 0 1 2
2 1 4 0 4 0 4 0 4 0 4 0 4 0 4 0 4 0 0 0 1 2
2 1 4 0 4 0 4 0 4 0 4 0 4 0 4 0 4 0 0 0 1 2
2 2 2 2 2 2 2 2 2 2 2 2 2 2 2 2 2 2 2 2 2 2