40 40
0 0
2 2 2 2 2 2 2 2 2 2 2 2 2 2 2 2 2 2 2 2 2 2 2 2 2 2 2 2 2 2 2 2 2 2 2 2 2 2 2 2
2 1 4 0 4 0 4 0 4 0 4 0 7 0 4 0 4 0 0 0 1 1 0 4 0 4 0 4 0 4 0 4 0 4 0 4 0 4 0 2
2 1 4 0 4 0 4 0 4 0 4 0 7 0 4 0 4 0 0 0 1 1 0 4 0 4 0 4 0 4 0 4 0 4 0 4 0 4 0 2
2 1 4 0 4 0 4 0 4 0 4 0 7 0 4 0 4 0 0 0 1 1 0 4 0 4 0 4 0 4 0 4 0 4 0 4 0 4 0 2
2 1 4 0 4 0 4 0 4 0 4 0 7 0 4 0 4 0 0 0 1 1 0 4 0 4 0 4 0 4 0 4 0 4 0 4 0 4 0 2
2 1 4 0 4 0 4 0 4 0 4 0 7 0 4 0 4 0 0 0 1 1 0 4 0 4 0 4 0 4 0 4 0 4 0 4 0 4 0 2
2 1 4 0 4 0 4 0 4 0 4 0 7 0 4 0 4 0 0 0 1 1 0 4 0 4 0 4 0 4 0 4 0 4 0 4 0 4 0 2
2 1 4 0 4 0 4 0 4 0 4 0 7 0 4 0 4 0 0 0 1 1 0 4 0 4 0 4 0 4 0 4 0 4 0 4 0 4 0 2
2 1 4 0 4 0 4 0 4 0 4 0 7 0 4 0 4 0 0 0 1 1 0 4 0 4 0 4 0 4 0 4 0 4 0 4 0 4 0 2
2 1 4 0 4 0 4 0 4 0 4 0 7 0 4 0 4 0 0 0 1 1 0 4 0 4 0 4 0 4 0 4 0 4 0 4 0 4 0 2
2 1 4 0 4 0 4 0 4 0 4 0 7 0 4 0 4 0 0 0 1 1 0 4 0 4 0 4 0 4 0 4 0 4 0 4 0 4 0 2
2 1 4 0 4 0 4 0 4 0 4 0 7 0 4 0 4 0 0 0 1 1 0 4 0 4 0 4 0 4 0 4 0 4 0 4 0 4 0 2
2 1 4 0 4 0 4 0 4 0 4 0 7 0 4 0 4 0 0 0 1 1 0 4 0 4 0 4 0 4 0 4 0 4 0 4 0 4 0 2
2 1 4 0 4 0 4 0 4 0 4 0 7 0 4 0 4 0 0 0 1 1 0 4 0 4 0 4 0 4 0 4 0 4 0 4 0 4 0 2
2 1 4 0 4 0 4 0 4 0 4 0 7 0 4 0 4 0 0 0 1 1 0 4 0 4 0 4 0 4 0 4 0 4 0 4 0 4 0 2
2 1 4 0 4 0 4 0 4 0 4 0 7 0 4 0 4 0 0 0 1 1 0 4 0 4 0 4 0 4 0 4 0 4 0 4 0 4 0 2
2 1 4 0 4 0 4 0 4 0 4 0 7 0 4 0 4 0 0 0 1 1 0 4 0 4 0 4 0 4 0 4 0 4 0 4 0 4 0 2
2 1 4 0 4 0 4 0 4 0 4 0 7 0 4 0 4 0 0 0 1 1 0 4 0 4 0 4 0 4 0 4 0 4 0 4 0 4 0 2
2 1 4 0 4 0 4 0 4 0 4 0 7 0 4 0 4 0 0 0 1 1 0 4 0 4 0 4 0 4 0 4 0 4 0 4 0 4 0 2
2 1 4 0 4 0 4 0 4 0 4 0 7 0 4 0 4 0 0 0 1 1 0 4 0 4 0 4 0 4 0 4 0 4 0 4 0 4 0 2
2 1 4 0 4 0 4 0 4 0 4 0 7 0 4 0 4 0 0 0 1 1 0 4 0 4 0 4 0 4 0 4 0 4 0 4 0 4 0 2
2 1 4 0 4 0 4 0 4 0 4 0 7 0 4 0 4 0 0 0 1 1 0 4 0 4 0 4 0 4 0 4 0 4 0 4 0 4 0 2
2 1 4 0 4 0 4 0 4 0 4 0 7 0 4 0 4 0 0 0 1 1 0 4 0 4 0 4 0 4 0 4 0 4 0 4 0 4 0 2
2 1 4 0 4 0 4 0 4 0 4 0 7 0 4 0 4 0 0 0 1 1 0 4 0 4 0 4 0 4 0 4 0 4 0 4 0 4 0 2
2 1 4 0 4 0 4 0 4 0 4 0 7 0 4 0 4 0 0 0 1 1 0 4 0 4 0 4 0 4 0 4 0 4 0 4 0 4 0 2
2 1 4 0 4 0 4 0 4 0 4 0 7 0 4 0 4 0 0 0 1 1 0 4 0 4 0 4 0 4 0 4 0 4 0 4 0 4 0 2
2 1 4 0 4 0 4 0 4 0 4 0 7 0 4 0 4 0 0 0 1 1 0 4 0 4 0 4 0 4 0 4 0 4 0 4 0 4 0 2
2 1 4 0 4 0 4 0 4 0 4 0 7 0 4 0 4 0 0 0 1 1 0 4 0 4 0 4 0 4 0 4 0 4 0 4 0 4 0 2
2 1 4 0 4 0 4 0 4 0 4 0 7 0 4 0 4 0 0 0 1 1 0 4 0 4 0 4 0 4 0 4 0 4 0 4 0 4 0 2
2 1 4 0 4 0 4 0 4 0 4 0 7 0 4 0 4 0 0 0 1 1 0 4 0 4 0 4 0 4 0 4 0 4 0 4 0 4 0 2
2 1 4 0 4 0 4 0 4 0 4 0 7 0 4 0 4 0 0 0 1 1 0 4 0 4 0 4 0 4 0 4 0 4 0 4 0 4 0 2
2 1 4 0 4 0 4 0 4 0 4 0 7 0 4 0 4 0 0 0 1 1 0 4 0 4 0 4 0 4 0 4 0 4 0 4 0 4 0 2
2 1 4 0 4 0 4 0 4 0 4 0 7 0 4 0 4 0 0 0 1 1 0 4 0 4 0 4 0 4 0 4 0 4 0 4 0 4 0 2
2 1 4 0 4 0 4 0 4 0 4 0 0 0 4 0 4 0 0 0 1 1 0 4 0 4 0 4 0 4 0 4 0 4 0 4 0 4 0 2
2 1 4 0 4 0 4 0 4 0 4 0 0 0 4 0 4 0 0 0 1 1 0 4 0 4 0 4 0 4 0 4 0 4 0 4 0 4 0 2
2 1 4 0 4 0 4 0 4 0 4 0 0 0 4 0 4 0 0 0 1 1 0 4 0 4 0 4 0 4 0 4 0 4 0 4 0 4 0 2
2 1 4 0 4 0 4 0 4 0 4 0 0 0 4 0 4 0 0 0 1 1 0 4 0 4 0 4 0 4 0 4 0 4 0 4 0 4 0 2
2 1 4 0 4 0 4 0 4 0 4 0 0 0 4 0 4 0 0 0 1 1 0 4 0 4 0 4 0 4 0 4 0 4 0 4 0 4 0 2
2 1 4 0 4 0 4 0 4 0 4 0 0 0 4 0 4 0 0 0 1 1 0 4 0 4 0 4 0 4 0 4 0 4 0 4 0 4 0 2
2 2 2 2 2 2 2 2 2 2 2 2 2 2 2 2 2 2 2 2 2 2 2 2 2 2 2 2 2 2 2 2 2 2 2 2 2 2 2 2






