50 50
0 0
2 2 2 2 2 2 2 2 2 2 2 2 2 2 2 2 2 2 2 2 2 2 2 2 2 2 2 2 2 2 2 2 2 2 2 2 2 2 2 2 2 2 2 2 2 2 2 2 2 2
2 1 4 0 4 0 4 0 4 0 4 0 7 0 4 0 4 0 0 0 1 8 5 3 5 3 5 3 5 3 5 3 2 3 5 3 5 2 5 3 5 3 5 3 5 3 3 3 1 2
2 1 4 0 4 0 4 0 4 0 4 0 7 0 4 0 4 0 0 0 1 8 5 3 5 3 5 3 5 3 5 3 2 3 5 3 5 2 5 3 5 3 5 3 5 3 3 3 1 2
2 1 4 0 4 0 4 0 4 0 4 0 7 0 4 0 4 0 0 0 1 8 5 3 5 3 5 3 5 3 5 3 2 3 5 3 5 2 5 3 5 3 5 3 5 3 3 3 1 2
2 1 4 0 4 0 4 0 4 0 4 0 7 0 4 0 4 0 0 0 1 8 5 3 5 3 5 3 5 3 5 3 2 3 5 3 5 2 5 3 5 3 5 3 5 3 3 3 1 2
2 1 4 0 4 0 4 0 4 0 4 0 7 0 4 0 4 0 0 0 1 8 5 3 5 3 5 3 5 3 5 3 2 3 5 3 5 2 5 3 5 3 5 3 5 3 3 3 1 2
2 1 4 0 4 0 4 0 4 0 4 0 4 0 4 0 4 0 0 0 1 8 5 3 5 3 5 3 5 3 5 3 2 3 5 3 5 2 5 3 5 3 5 3 5 3 3 3 1 2
2 1 4 0 4 0 4 0 4 0 4 0 4 0 4 0 4 0 0 0 1 8 5 3 5 3 5 3 5 3 5 3 2 3 5 3 5 2 5 3 5 3 5 3 5 3 3 3 1 2
2 1 4 0 4 0 4 0 4 0 4 0 4 0 4 0 4 0 0 0 1 8 5 3 5 3 5 3 5 3 5 3 2 2 2 2 2 2 5 3 5 3 5 3 5 3 3 3 1 2
2 1 4 0 4 0 4 0 4 0 4 0 4 0 4 0 4 0 0 0 1 8 5 3 5 3 5 3 5 3 5 3 5 3 5 3 5 3 5 3 5 3 5 3 5 3 3 3 1 2
2 1 4 0 4 0 4 0 4 0 4 0 4 0 4 0 4 0 0 0 1 8 5 3 5 3 5 3 5 3 5 3 5 3 5 3 5 3 5 3 5 3 5 3 5 3 3 3 1 2
2 1 4 0 4 0 4 0 4 0 4 0 4 0 4 0 4 0 0 0 1 8 5 3 5 3 5 3 5 3 5 3 5 3 5 3 5 3 5 3 5 3 5 3 5 3 3 3 1 2
2 1 4 0 4 0 4 0 4 0 4 0 4 0 4 0 4 0 0 0 1 8 5 3 5 3 5 3 5 3 5 3 5 3 5 3 5 3 5 3 5 3 5 3 5 3 3 3 1 2
2 1 7 7 7 7 7 7 7 7 4 0 4 0 4 0 4 0 0 0 1 8 5 3 5 3 5 3 5 3 6 6 6 7 5 3 5 3 5 3 5 3 5 3 5 3 3 3 1 2
2 1 4 0 4 0 4 0 4 0 4 0 4 0 4 0 4 0 0 0 1 8 5 3 5 3 5 3 5 3 5 3 5 7 5 3 5 3 5 3 5 3 5 3 5 3 3 3 1 2
2 1 4 0 4 0 4 0 4 0 4 0 4 0 4 0 4 0 0 0 1 8 5 3 5 3 5 3 5 3 5 3 5 7 5 3 5 3 5 3 5 3 5 3 5 3 3 3 1 2
2 1 4 0 4 0 4 0 4 0 4 0 4 0 4 0 4 0 0 0 1 8 5 3 5 3 5 3 5 3 5 3 5 7 5 3 5 3 5 3 5 3 5 3 5 3 3 3 1 2
2 1 4 0 4 0 4 0 4 0 4 0 4 0 4 0 4 0 0 0 1 8 5 3 5 3 5 3 5 3 5 3 5 3 5 3 5 3 5 3 5 3 5 3 5 3 3 3 1 2
2 1 4 0 4 0 4 0 4 0 4 0 4 0 4 0 4 0 0 0 1 8 5 3 5 3 5 3 5 3 5 3 5 3 5 3 5 3 5 3 5 3 5 3 5 3 3 3 1 2
2 1 4 0 4 0 4 0 4 0 4 0 4 0 4 0 4 0 0 0 1 8 5 3 5 3 5 3 5 3 5 3 5 3 5 3 5 3 5 3 5 3 5 3 5 3 3 3 1 2
2 1 4 0 4 0 4 0 4 0 4 0 4 0 4 0 4 0 0 0 1 8 5 3 5 3 5 3 5 3 5 3 5 3 5 3 5 3 5 3 5 3 5 3 5 3 3 3 1 2
2 1 4 0 4 0 4 0 4 0 4 0 4 0 4 0 4 0 0 0 1 8 5 3 5 3 5 3 5 3 5 3 5 3 5 3 5 3 5 3 5 3 5 3 5 3 3 3 1 2
2 1 4 0 4 0 4 0 4 0 4 0 4 0 4 0 4 0 0 0 1 8 5 3 5 3 5 3 5 3 5 3 5 3 5 3 5 3 5 3 5 3 5 3 5 3 3 3 1 2
2 1 4 0 4 0 4 0 4 0 4 0 4 0 4 0 4 0 0 0 1 8 5 3 5 3 5 3 5 3 5 3 5 3 5 3 5 3 5 3 5 3 5 3 5 3 3 3 1 2
2 1 4 0 4 0 4 0 4 0 4 0 4 0 4 0 4 0 0 0 1 8 5 3 5 3 5 3 5 3 5 3 5 3 5 3 5 3 5 3 5 3 5 3 5 3 3 3 1 2
2 1 4 0 4 0 4 0 4 0 4 0 4 0 4 0 4 0 0 0 1 8 5 3 5 3 5 3 5 3 5 3 5 3 5 3 5 3 5 3 5 3 5 3 5 3 3 3 1 2
2 1 4 0 4 0 4 0 4 0 4 0 4 0 4 0 4 0 0 0 1 8 5 3 5 3 5 3 5 3 5 3 5 3 5 3 5 3 5 3 5 3 5 3 5 3 3 3 1 2
2 1 4 0 4 0 4 0 4 0 4 0 4 0 4 0 4 0 0 0 1 8 5 3 5 3 5 3 5 3 5 3 5 3 5 3 5 3 5 3 5 3 5 3 5 3 3 3 1 2
2 1 4 0 4 0 4 0 4 0 4 0 4 0 4 0 4 0 0 0 1 8 5 3 5 3 5 3 5 3 5 3 5 3 5 3 5 3 5 3 5 3 5 3 5 3 3 3 1 2
2 1 4 0 4 0 4 0 4 0 4 0 4 0 4 0 4 0 0 0 1 8 5 3 5 3 5 3 5 3 5 3 5 3 5 3 5 3 5 3 5 3 5 3 5 3 3 3 1 2
2 1 4 0 4 0 4 0 4 0 4 0 4 0 4 0 4 0 0 0 1 8 5 3 5 3 5 3 5 3 5 3 5 3 5 3 5 3 5 3 5 3 5 3 5 3 3 3 1 2
2 1 4 0 4 0 4 0 4 0 4 0 4 0 4 0 4 0 0 0 1 8 5 3 5 3 5 3 5 3 5 3 5 3 5 3 5 3 5 3 5 3 5 3 5 3 3 3 1 2
2 1 4 0 4 0 4 0 4 0 4 0 4 0 4 0 4 0 0 0 1 8 5 3 5 3 5 3 5 3 5 3 5 3 5 3 5 3 5 3 5 3 5 3 5 3 3 3 1 2
2 1 4 0 4 0 4 0 4 0 4 0 4 0 4 0 4 0 0 0 1 8 5 3 5 3 5 3 5 3 5 3 5 3 5 3 5 3 5 3 5 3 5 3 5 3 3 3 1 2
2 1 4 0 4 0 4 0 4 0 4 0 4 0 4 0 4 0 0 0 1 8 5 3 5 3 5 3 5 3 5 3 5 3 5 3 5 3 5 3 5 3 5 3 5 3 3 3 1 2
2 1 4 0 4 0 4 0 4 0 4 0 4 0 4 0 4 0 0 0 1 8 5 3 5 3 5 3 5 3 5 3 5 3 5 3 5 3 5 3 5 3 5 3 5 3 3 3 1 2
2 1 4 0 4 0 4 0 4 0 4 0 4 0 4 0 4 0 0 0 1 8 5 3 5 3 5 3 5 3 5 3 5 3 5 3 5 3 5 3 5 3 5 3 5 3 3 3 1 2
2 1 4 0 4 0 4 0 4 0 4 0 4 0 4 0 4 0 0 0 1 8 5 3 5 3 5 3 5 3 5 3 5 3 5 3 5 3 5 3 5 3 5 3 5 3 3 3 1 2
2 1 4 0 4 0 4 0 4 0 4 0 4 0 4 0 4 0 0 0 1 8 5 3 5 3 5 3 5 3 5 3 5 3 5 3 5 3 5 3 5 3 5 3 5 3 3 3 1 2
2 1 4 0 4 0 4 0 4 0 4 0 4 0 4 0 4 0 0 0 1 8 5 3 5 3 5 3 5 3 5 3 5 3 5 3 5 3 5 3 5 3 5 3 5 3 3 3 1 2
2 1 4 0 4 0 4 0 4 0 4 0 4 0 4 0 4 0 0 0 1 8 5 3 5 3 5 3 5 3 5 3 5 3 5 3 5 3 5 3 5 3 5 3 5 3 3 3 1 2
2 1 4 0 4 0 4 0 4 0 4 0 4 0 4 0 4 0 0 0 1 8 5 3 5 3 5 3 5 3 5 3 5 3 5 3 7 7 7 3 5 3 5 3 5 3 3 3 1 2
2 1 4 0 4 0 4 0 4 0 4 0 4 0 4 0 4 0 0 0 1 8 5 3 5 3 5 3 5 3 5 3 5 3 5 3 7 3 5 3 5 3 5 3 5 3 3 3 1 2
2 1 4 0 4 0 4 0 4 0 4 0 4 0 4 0 4 0 0 0 1 8 5 3 5 3 5 3 5 3 5 3 5 3 5 3 7 3 5 3 5 3 5 3 5 3 3 3 1 2
2 1 4 0 4 0 4 0 4 0 4 0 4 0 4 0 4 0 0 0 1 8 5 3 5 3 5 3 5 3 5 3 5 3 5 3 7 3 5 3 5 3 5 3 5 3 3 3 1 2
2 1 4 0 4 0 4 0 4 0 4 0 4 0 4 0 4 0 0 0 1 8 5 3 5 3 5 3 5 3 5 3 5 3 5 3 7 3 5 3 5 3 5 3 5 3 3 3 1 2
2 1 4 0 4 0 4 0 4 0 4 0 4 0 4 0 4 0 0 0 1 8 5 3 5 3 5 3 5 3 5 3 5 3 5 3 7 3 5 3 5 3 5 3 5 3 3 3 1 2
2 1 4 0 4 0 4 0 4 0 4 0 4 0 4 0 4 0 0 0 1 8 5 3 5 3 5 3 5 3 5 3 5 3 5 3 7 3 5 3 5 3 5 3 5 3 3 3 1 2
2 1 4 0 4 0 4 0 4 0 4 0 4 0 4 0 4 0 0 0 1 8 5 3 5 3 5 3 5 3 5 3 5 3 5 3 7 3 5 3 5 3 5 3 5 3 3 3 1 2
2 2 2 2 2 2 2 2 2 2 2 2 2 2 2 2 2 2 2 2 2 2 2 2 2 2 2 2 2 2 2 2 2 2 2 2 2 2 2 2 2 2 2 2 2 2 2 2 2 2

